[-----]000000000000000000000
/...../000000000000000000000
/...../000000000000000000000
/...../000000000000000000000
/...../000000000000000000000
/...../0[-----------------]0
/...../0/................./0
/...../0/................^/0
/...../0/................./0
/...../0(-------...-------/0
/.....(-)................./0
/........................./0
/.........................e0
(--w----]................./0
00000000(----s------------)0
0000000000000000000000000000