+++++++++0000000000000000000
+.....+++0000000000000000000
+.....+++0000000000000000000
+.....+++0000000000000000000
+.....+++0000000000000000000
+.....+++++++++++++++++++++0
+.....+++................++0
+.....+++................-+0
+.....+++................++0
+.....++++++++++...++++++++0
+.....+++.................+0
+.........................E0
+.....+++.................e0
++WwW++++.................E0
00000000++++SsS++++++++++++0
0000000000000000000000000000