+++++++++                   
+.....+++                   
+.....+++                   
+.....+++                   
+.....+++                   
+.....+++                   
+.....++++++++++++++++++++++
+.....+++.................++
+.....+++.................-+
+.....+++.................++
+.....++++++++++...+++++++++
+.....+++..................+
+..........................E
++WWW++++..................E
        +..................E
        ++++SSS+++++++++++++