+++++++++                   
+.....+++                   
+.....+++                   
+.....+++                   
+.....+++                   
+.....+++                   
+.....++++++++++++++++++++++
+.....+++.................++
+.....+++.................-+
+.....+++.................++
+.....++++++++++...+++++++++
+.....+++..................+
+..........................E
++WwW++++..................e
        +..................E
        ++++SsS+++++++++++++