............................
............................
............................
............................
......++++++++++++++++......
......+8d8+hhhhbhhhhh+......
......+8^8+333f^e3333+......
......+878+2222222222+......
......+878+++++2++++++......
......+878+6666666666+......
......+87775555555555E......
......+878+6666666666+......
......++W++++++S++++++......
............................
............................
............................