0000000000000000000000000000
0[-----------------------n]0
0/......................../0
0/.[----------------------)0
0/./000000000000000000000000
0/./000000000000000000000000
0/.(----------------------]0
0/........................e0
0/.[----------------------)0
0/./000000000000000000000000
0/./000000000000000000000000
0/./000000000000000000000000
0/./000000000000000000000000
0/./000000000000000000000000
0(s)000000000000000000000000
0000000000000000000000000000