............................
.////////////////////////N/.
./444444444444444444444444/.
./4////////////////////////.
./4/........................
./4/........................
./4////////////////////////.
./444444444444444444444444E.
./4////////////////////////.
./4/........................
./4/........................
./4/........................
./4/........................
./4/........................
./S/........................
............................