............................
....................../N/...
....................../4/...
.........//////////////4/...
........./444444444444/4/...
./////////4/////////4//4/...
.W444444444/////////4//4/...
.///////////////////4//4/...
............../444444444/...
............../4/////////...
............../4/...........
...////////////4/...........
.../444444444444/...........
.../4////////////...........
.../S/......................
............................