0000000000000000000000000000
0000000000000000000000+n+000
0000000000000000000000+.+000
000000000++++++++++++++.+000
000000000+............+.+000
0+++++++++.++++++++...+.+000
0w.........++++++++...+.+000
0++++++++++++++++++...+.+000
00000000000000+.........+000
00000000000000+.+++++++++000
00000000000000+.+00000000000
000++++++++++++.+00000000000
000+............+00000000000
000+.++++++++++++00000000000
000+s+0000000000000000000000
0000000000000000000000000000