                      +N+   
                      +.+   
                      +.+   
         ++++++++++++++.+   
         +...........++.+   
++++++++++.+++++++++.++.+   
W..........+++++++++.++.+   
++++++++++++++++++++.++.+   
              +.........+   
              +.+++++++++   
              +.+           
   ++++++++++++.+           
   +............+           
   +.++++++++++++           
   +.+                      
   +S+                      