............................
.....++++++++++++...........
.....+chhcbchhhc+...........
.....+777g!e7777+...........
.....+8888888888+...........
.....+++++8++++++...........
.....+6666666666+...........
.....W5555555555E...........
.....+6666666666+...........
.....++++8+++++++...........
........+888!e+.............
........+++++++.............
............................
............................
............................
............................