++++++++++++++++++++++++++++
+..........................+
+..........+++++...........+
+..........+++++...........+
+..........+++++...........+
+..........................+
++++++++++++...+++++++++++++
W..........................E
w..........................e
W..........................E
++++++++++++...+++++++++++++
+..........................+
+..........................+
+...........+-+............+
+..........+++++...........+
++++++++++++++++++++++++++++