0++++++++++++++++++++++++++0
0+........................+0
0+.........+++++..........+0
0+.........+++++..........+0
0+.........+++++..........+0
0+........................+0
0+++++++++++...++++++++++++0
0W........................E0
0w........................e0
0W........................E0
0+++++++++++...++++++++++++0
0+........................+0
0+........................+0
0+..........+-+...........+0
0+.........+++++..........+0
0++++++++++++++++++++++++++0