0[------------------------]0
0/......................../0
0/.........[---]........../0
0/........./000/........../0
0/.........(---)........../0
0/......................../0
0/----------...-----------/0
0/......................../0
0w........................e0
0/......................../0
0/----------...-----------/0
0/......................../0
0/......................../0
0/..........[!].........../0
0/.........[)0(]........../0
0(------------------------)0