............................
............................
............................
........+++++N+++++.........
........+000030000+.........
........+033333330+.........
........+030000030+.........
........+030jjj030+.........
........W030jjj030E.........
........+030jjj030+.........
........+030000030+.........
........+033333330+.........
........+000000000+.........
........+++++S+++++.........
............................
............................