0000000000000000000000000000
0000000000000000000000000000
0000000000000000000000000000
0000000000000000000000000000
00000000[----n----]000000000
00000000/........./000000000
00000000/........./000000000
00000000/...[-].../000000000
00000000w.../0/...e000000000
00000000/...(-).../000000000
00000000/........./000000000
00000000/........./000000000
00000000(----s----)000000000
0000000000000000000000000000
0000000000000000000000000000
0000000000000000000000000000