............................
............................
............................
............................
........+++++N+++++.........
........+000030000+.........
........+000030000+.........
........+000030000+.........
........W333333333E.........
........+000030000+.........
........+000030000+.........
........+000030000+.........
........+++++S+++++.........
............................
............................
............................