0000000000000000000000000000
0000000000000000000000000000
0000000000000000000000000000
0000000000000000000000000000
00000000++++NnN++++000000000
00000000+.........+000000000
00000000+.........+000000000
00000000W...+++...E000000000
00000000w...+++...e000000000
00000000W...+++...E000000000
00000000+.........+000000000
00000000+.........+000000000
00000000++++SsS++++000000000
0000000000000000000000000000
0000000000000000000000000000
0000000000000000000000000000