............................
............................
............................
...........++N++............
...........+919+............
...........+919+............
...........+919+............
.......+++++919++++++E+++...
.......+7%7+919+1111111k+...
.......+77799199111111#e+...
.......+++++91911111111f+...
...........+999911111111+...
...........++++++++++++++...
............................
............................
............................