0000000000000000000000000000
00000000000[-n-]000000000000
00000000000/.../000000000000
00000000000/.../000000000000
00000000000/.../000000000000
00000000000/.../000000000000
00000000000/.../000000000000
0[---------/.../--------e-]0
0/........./.../........../0
0/........./.../........../0
0/........./.../........../0
0/......................../0
0/........./.../........../0
0/........./.../........../0
0/........./.../#........./0
0[------------------------]0