+++++++++++++++++00000000000
+...............+00000000000
+...........-...+00000000000
+...............+00000000000
+...............+00000000000
+...-...........+00000000000
+...............+00000000000
+...............+00000000000
+...............+00000000000
+........-......+++++n+++++0
+...............+.........+0
+...............+.........E0
+.........................e0
+...............+.........E0
+...............+.........+0
+++++++++++++++++++++++++++0