[---------------]00000000000
/.............../00000000000
/.............../00000000000
/.............../00000000000
/.............../00000000000
/...*.........../00000000000
/.............../00000000000
/.............../00000000000
/.............../00000000000
/.............../----n----]0
/.............../........./0
/.............../........./0
/.........................e0
/.............../........./0
/.............../........./0
(-------------------------]0