+++++++++++++++++           
+.............-.+           
+..-............+           
+.......-.......+           
+...............+           
+............-..+           
+...............+           
+.-.............+           
+...............+           
+...............+++++n++++++
+...............+..........+
+...............+..........E
+..........................e
+...............+..........E
+...............+..........+
++++++++++++++++++++++++++++