+++++++++++++++++...........
+000000000000000+...........
+000000000000000+...........
+0000000*0000000+...........
+000000000000000+...........
+000*00000000000+...........
+000000000000000+...........
+000000000000000+...........
+000000000000000+...........
+00000000*000000+...........
+000000000000000++++++N++++.
+000*00000000000+666666666+.
+0000000000000005555555555E.
+000000000000000+666666666+.
+++++++++++++++++++++++++++.
+++++++++++++++++++++++++++.