............................
............................
........+++++++++++++++++++.
........+1hhh111hhh111hhh1+.
........+11a11111a11111a11+.
........+11;11111;11111;11+.
........++++++++111++++++++.
........+66666666666666666+.
........W55555555555555555E.
........+66666666666666666+.
........++++++++1++++++++++.
...............+1111111;kl+.
...............++++++++++++.
............................
............................
............................