0000000000000000000000000000
0[------------n------------]
0/................./0/...../
0/................./0/...../
0/................./0/...../
0/................./-----.-/
0/................./......./
0w................./......./
0/................./......./
0/...!.#.;.?.*.^.../......./
0/........................./
0/................./......./
0/................./......./
0/................./......./
0(---------------s---------)
0000000000000000000000000000