++++++++++++   +++++++++++++
+...........NnN....+++.....+
+..................+++.....+
+..................+++.....+
+..................+++.....+
+..................++++++.++
 W.................+.......+
 w.................+.......+
 W.................+.......+
+..................+.......+
+..........................+
+..................+.......+
+..................+.......+
+..................+.......+
+..............SsS.+.......+
+++++++++++++++   ++++++++++