++++++++++++NNN+++++++++++++
+..................+++.....+
+..................+++.....+
+..................+++.....+
+..................+++.....+
+..................++++++.++
W..................+.......+
W..................+.......+
W..................+.......+
+..................+.......+
+..........................+
+..................+.......+
+..................+.......+
+..................+.......+
+..................+.......+
+++++++++++++++SSS++++++++++