0000000000000000000000000000
0-------------n-------------
0\................./+\...../
0\................./+\...../
0\................./-\...../
0\................./_____._/
0\................./......./
0w................./......./
0\................./......./
0\................./......./
0\........................./
0\................./......./
0\................./......./
0\................./......./
0_______________s___________
0000000000000000000000000000