............................
............................
............................
............................
..........+++N+++++++.......
..........+27772+++n+.......
..........+27772+++0+.......
..........W77772+++0+.......
..........+277720000+.......
..........+27772+000+.......
..........+27772+00i+.......
..........+++S+++++++.......
............................
............................
............................
............................