0000000000000000000000000000
0++++++++++++NnN++++++.....+
0+.................+++.....+
0+.................+++.....+
0+.................+++.....+
0+.................++++++.++
0W.................+.......+
0w.................+.......+
0W.................+.......+
0+.................+.......+
0+.........................+
0+.................+.......+
0+.................+.......+
0+.................+.......+
0++++++++++++++SsS++++++++++
0000000000000000000000000000