............................
............................
............................
............................
.......++++++++++...........
.......+jjcjcjjj+...........
.......+jb4m4f4j+...........
.......+j44?444j+...........
.......+44444444+...........
.......+22222222+...........
.......+++++2+++++++++++++++
.......+66666666+jbjbjjbjbj+
.......W5555555588[8]88(8)8+
.......+66666666++++++++++++
.......+++++++S+++++++++++++
............................