0000000000000000000000000000
0000000000000000000000000000
0000000000000000000000000000
0000000000000000000000000000
0000000000000000000000000000
0[--------------]00000000000
0/............../00000000000
0/............../00000000000
0/............../00000000000
0/............../00000000000
0w..............(----------)
0/........................./
0/......+................../
0/........................./
0(------s------------------)
0000000000000000000000000000