0000000000000000000000000000
0000000000000000000000000000
0000000000000000000000000000
0000000000000000000000000000
0000000000000000000000000000
0++++++++++++++++00000000000
0++....+-+......+00000000000
0++.............+00000000000
0++.............+00000000000
0W..............+00000000000
0w..............++++++++++++
0W..............+..........+
0++........................+
0++.............+..........+
0++++++SsS++++++++++++++++++
0000000000000000000000000000