                            
                            
                            
                            
                            
++++++++++++++++            
++....+-+......+            
++.............+            
++.............+            
W..............+            
w..............+++++++++++++
W..............+...........+
++.........................+
++.............+...........+
++++++...+++++++++++++++++++
++++++SsS+++++++++++++++++++