++++++++
NNNNNN++
+....+++
+....+++
SSSSSS++
------++
++++++++
