++++++++++++++++++++++++++++
++++++++++++NNN+++++++++++++
+..........................+
+..........................+
W..........++-++...........E
W..........+++++...........E
W..........+++++...........E
+..........................+
+..........................+
+..........................+
+...........    ...........+
+..........................+
+..........................+
+..........................+
++++++++++++++++++++++++++++
++++++++++++SSS+++++++++++++